11111
11011
10101
11011
11111
14